0 0 0 0 0 0 0 0 0 0 0 0 0 0 0
0 1 1 1 2 1 2 1 1 1 1 2 1 1 0
0 1 4 2 4 3 4 3 4 1 4 1 4 1 0
0 1 1 6 2 1 3 5 1 1 1 2 3 2 0
0 1 4 3 4 2 4 1 4 3 4 1 4 2 0
0 2 1 2 1 3 1 1 3 2 1 3 1 1 0
0 3 4 1 4 1 4 2 4 1 4 8 4 2 0
0 1 3 5 2 1 1 3 1 2 1 3 1 1 0
0 1 4 1 4 1 4 1 4 3 4 1 4 5 0
0 1 5 2 1 2 1 3 1 2 1 3 1 1 0
0 3 4 1 4 1 4 7 4 1 4 2 4 2 0
0 1 3 5 2 1 1 3 1 2 1 3 1 1 0
0 1 4 1 4 1 4 1 4 3 4 1 4 5 0
0 1 5 2 1 2 1 3 1 2 1 3 1 1 0
0 0 0 0 0 0 0 0 0 0 0 0 0 0 0